1111111
1P00C01
10010C1
10C00E1